1111111111111111111111111111111
100CCCCCCCCCC11CCCCCCCCCCC0CCC1
1C1111C11111C11C11111C11111C1C1
1C1111C11111C11C11111C11111C1C1
1CCCCCCCCCCCCCCCCCCCCCCCCCCCCC1
1C1111C11C11111111C11C11111C1C1
1C1111C11C11111111C11C11111C1C1
1CCCCCC11CCCC11CCCC11CCCCCCCCC1
1111111C1111C11C1111C11111111C1
1111111C1CCCCCCCCCC1C11111111C1
1111111C1C111CC111C1C11111111C1
1111111C1C1CCCCCC1C1C11111111C1
1111111C1C11111111C1CC1111111C1
1CCCCCCCCCCCCECCCCCCCCCCCCCCCC1
1C1111C11111C11C11111C1111CC1C1
1C1111C11111C11C11111C11111C1C1
1CCC11CCCPCCCCCCCCCCCCCCC11CCC1
111C11C11C11111111C11C11C11G111
111C11C11C11111111C11C11C11C111
1CCCCCC11CCCCC1CCCC11CCCCCCCCC1
1C11111111111C11C111111111111C1
1C11111111111CCCC111111111111C1
1111111111111111111111111111111
