11111111111111111111111111
10000000000000000000000011
10000000000000000000000001
10000P00000000000000000001
10000000000000000000000001
10000000000000000000000001
10000E00000000000000010001
10000000000000000000000001
100000C0000000000000000001
10000000000000000000000001
10000000000000000000000001
10000000000000000000000001
11111111111111111111111111
